AAHZ	AAHZ CORPORATION	N	*NULL*
ADELARD	ADELARD CORPORATION	N	*NULL*
ADMON	ADMON CORPORATION	N	*NULL*
ADMONFAYE	ADMONFAYE CORPORATION	N	*NULL*
AIGLOS	AIGLOS CORPORATION	N	*NULL*
ALDOR	ALDOR CORPORATION	N	*NULL*
ALIA	ALIA CORPORATION	N	*NULL*
AMBER	AMBER CORPORATION	N	*NULL*
AMONHEM	AMONHEM CORPORATION	N	*NULL*
AMONSUL	AMONSUL CORPORATION	N	*NULL*
AMROTH	AMROTH CORPORATION	N	*NULL*
ANARION	ANARION CORPORATION	N	*NULL*
ANBORN	ANBORN CORPORATION	N	*NULL*
ANCALAGON	ANCALAGON CORPORATION	N	*NULL*
ANDUIN	ANDUIN CORPORATION	N	*NULL*
ANDURIL	ANDURIL CORPORATION	N	*NULL*
ANGBOR	ANGBOR CORPORATION	N	*NULL*
ANGMAR	ANGMAR CORPORATION	N	*NULL*
ANGRENOST	ANGRENOST CORPORATION	N	*NULL*
ANOR	ANOR CORPORATION	N	*NULL*
APPLEDORE	APPLEDORE CORPORATION	N	*NULL*
ARAGORN	ARAGORN CORPORATION	N	*NULL*
ARATHON	ARATHON CORPORATION	N	*NULL*
ARDEN	ARDEN CORPORATION	N	*NULL*
ARGELEB	ARGELEB CORPORATION	N	*NULL*
ARGONATH	ARGONATH CORPORATION	N	*NULL*
ARHA	ARHA CORPORATION	N	*NULL*
ARNOR	ARNOR CORPORATION	N	*NULL*
AROD	AROD CORPORATION	N	*NULL*
ARRAKIS	ARRAKIS CORPORATION	N	*NULL*
ARREN	ARREN CORPORATION	N	*NULL*
ARTHURDENT	ARTHURDENT CORPORATION	N	*NULL*
ARVEDUI	ARVEDUI CORPORATION	N	*NULL*
ARWEN	ARWEN CORPORATION	N	*NULL*
ASFALOTH	ASFALOTH CORPORATION	N	*NULL*
ASIMOV	ASIMOV CORPORATION	N	*NULL*
ATREIDES	ATREIDES CORPORATION	N	*NULL*
ATREYU	ATREYU CORPORATION	N	*NULL*
ATUAN	ATUAN CORPORATION	N	*NULL*
BAGEND	BAGEND CORPORATION	N	*NULL*
BAGGINS	BAGGINS CORPORATION	N	*NULL*
BAGSHOT	BAGSHOT CORPORATION	N	*NULL*
BALDOR	BALDOR CORPORATION	N	*NULL*
BALIN	BALIN CORPORATION	N	*NULL*
BALROG	BALROG CORPORATION	N	*NULL*
BANDOBRAS	BANDOBRAS CORPORATION	N	*NULL*
BARABDUIN	BARABDUIN CORPORATION	N	*NULL*
BARADDUR	BARADDUR CORPORATION	N	*NULL*
BARADUR	BARADUR CORPORATION	N	*NULL*
BARAHIR	BARAHIR CORPORATION	N	*NULL*
BARANOR	BARANOR CORPORATION	N	*NULL*
BARON	BARON CORPORATION	N	*NULL*
BARROWBLADE	BARROWBLADE CORPORATION	N	*NULL*
BASTIAN	BASTIAN CORPORATION	N	*NULL*
BBAGGINS	BBAGGINS CORPORATION	N	*NULL*
BEEBLEBROX	BEEBLEBROX CORPORATION	N	*NULL*
BEECHBONE	BEECHBONE CORPORATION	N	*NULL*
BENADAR	BENADAR CORPORATION	N	*NULL*
BENBOVA	BENBOVA CORPORATION	N	*NULL*
BENDEN	BENDEN CORPORATION	N	*NULL*
BENEDICT	BENEDICT CORPORATION	N	*NULL*
BEORN	BEORN CORPORATION	N	*NULL*
BEORNINGS	BEORNINGS CORPORATION	N	*NULL*
BEPPO	BEPPO CORPORATION	N	*NULL*
BEREGOND	BEREGOND CORPORATION	N	*NULL*
BEREN	BEREN CORPORATION	N	*NULL*
BERGIL	BERGIL CORPORATION	N	*NULL*
BERUTHIEL	BERUTHIEL CORPORATION	N	*NULL*
BIFUR	BIFUR CORPORATION	N	*NULL*
BIGFOLK	BIGFOLK CORPORATION	N	*NULL*
BILBO	BILBO CORPORATION	N	*NULL*
BINK	BINK CORPORATION	N	*NULL*
BIPOHL	BIPOHL CORPORATION	N	*NULL*
BLACKCAPTAIN	BLACKCAPTAIN CORPORATION	N	*NULL*
BLACKGATE	BLACKGATE CORPORATION	N	*NULL*
BLACKONES	BLACKONES CORPORATION	N	*NULL*
BLACKPIT	BLACKPIT CORPORATION	N	*NULL*
BLACKRIDER	BLACKRIDER CORPORATION	N	*NULL*
BLACKROOT	BLACKROOT CORPORATION	N	*NULL*
BLACKSTONE	BLACKSTONE CORPORATION	N	*NULL*
BOFFIN	BOFFIN CORPORATION	N	*NULL*
BOFOR	BOFOR CORPORATION	N	*NULL*
BOLGER	BOLGER CORPORATION	N	*NULL*
BOMBADIL	BOMBADIL CORPORATION	N	*NULL*
BOMBUR	BOMBUR CORPORATION	N	*NULL*
BOROMIR	BOROMIR CORPORATION	N	*NULL*
BOUNDERS	BOUNDERS CORPORATION	N	*NULL*
BOVA	BOVA CORPORATION	N	*NULL*
BOWMAN	BOWMAN CORPORATION	N	*NULL*
BRACEGIRDLE	BRACEGIRDLE CORPORATION	N	*NULL*
BRADBURY	BRADBURY CORPORATION	N	*NULL*
BRAND	BRAND CORPORATION	N	*NULL*
BRANDYBUCK	BRANDYBUCK CORPORATION	N	*NULL*
BRANDYWINE	BRANDYWINE CORPORATION	N	*NULL*
BREE	BREE CORPORATION	N	*NULL*
BREEHILL	BREEHILL CORPORATION	N	*NULL*
BREGALAND	BREGALAND CORPORATION	N	*NULL*
BREGO	BREGO CORPORATION	N	*NULL*
BROCKHOUSE	BROCKHOUSE CORPORATION	N	*NULL*
BRUEINEN	BRUEINEN CORPORATION	N	*NULL*
BRUNNER	BRUNNER CORPORATION	N	*NULL*
BULLROARER	BULLROARER CORPORATION	N	*NULL*
BURARUM	BURARUM CORPORATION	N	*NULL*
BURROWS	BURROWS CORPORATION	N	*NULL*
BUTTERBUR	BUTTERBUR CORPORATION	N	*NULL*
BUTTERCUP	BUTTERCUP CORPORATION	N	*NULL*
BYWATER	BYWATER CORPORATION	N	*NULL*
CABRA	CABRA CORPORATION	N	*NULL*
CAINE	CAINE CORPORATION	N	*NULL*
CALADAN	CALADAN CORPORATION	N	*NULL*
CAPTAINKIRK	CAPTAINKIRK CORPORATION	N	*NULL*
CARADHRAS	CARADHRAS CORPORATION	N	*NULL*
CARLCOREY	CARLCOREY CORPORATION	N	*NULL*
CARMELLA	CARMELLA CORPORATION	N	*NULL*
CASSIOPEIA	CASSIOPEIA CORPORATION	N	*NULL*
CELEBDIL	CELEBDIL CORPORATION	N	*NULL*
CELEBORN	CELEBORN CORPORATION	N	*NULL*
CELEBRANT	CELEBRANT CORPORATION	N	*NULL*
CELEBRIAN	CELEBRIAN CORPORATION	N	*NULL*
CELEBRIMOR	CELEBRIMOR CORPORATION	N	*NULL*
CEORL	CEORL CORPORATION	N	*NULL*
CHANI	CHANI CORPORATION	N	*NULL*
CHAOS	CHAOS CORPORATION	N	*NULL*
CHIMOLITHA	CHIMOLITHA CORPORATION	N	*NULL*
CHUBB	CHUBB CORPORATION	N	*NULL*
CIRDAN	CIRDAN CORPORATION	N	*NULL*
CIRION	CIRION CORPORATION	N	*NULL*
CIRITH	CIRITH CORPORATION	N	*NULL*
CITADEL	CITADEL CORPORATION	N	*NULL*
CLARK	CLARK CORPORATION	N	*NULL*
CLARKE	CLARKE CORPORATION	N	*NULL*
CLOUDYHEAD	CLOUDYHEAD CORPORATION	N	*NULL*
COREY	COREY CORPORATION	N	*NULL*
CORSAIRS	CORSAIRS CORPORATION	N	*NULL*
CORWIN	CORWIN CORPORATION	N	*NULL*
CRACKOFDOOM	CRACKOFDOOM CORPORATION	N	*NULL*
CREBAIN	CREBAIN CORPORATION	N	*NULL*
CROMBIE	CROMBIE CORPORATION	N	*NULL*
CROSSROADS	CROSSROADS CORPORATION	N	*NULL*
CUTTER	CUTTER CORPORATION	N	*NULL*
DAIN	DAIN CORPORATION	N	*NULL*
DAMROD	DAMROD CORPORATION	N	*NULL*
DARKCITY	DARKCITY CORPORATION	N	*NULL*
DARKDOOR	DARKDOOR CORPORATION	N	*NULL*
DARKLORD	DARKLORD CORPORATION	N	*NULL*
DARKTOWER	DARKTOWER CORPORATION	N	*NULL*
DEADCITY	DEADCITY CORPORATION	N	*NULL*
DEADMARSHES	DEADMARSHES CORPORATION	N	*NULL*
DEAGOL	DEAGOL CORPORATION	N	*NULL*
DELVING	DELVING CORPORATION	N	*NULL*
DENETHOR	DENETHOR CORPORATION	N	*NULL*
DENT	DENT CORPORATION	N	*NULL*
DENTARTHUR	DENTARTHUR CORPORATION	N	*NULL*
DEOR	DEOR CORPORATION	N	*NULL*
DEORWINE	DEORWINE CORPORATION	N	*NULL*
DERNHELM	DERNHELM CORPORATION	N	*NULL*
DERUFIN	DERUFIN CORPORATION	N	*NULL*
DERVOERIN	DERVOERIN CORPORATION	N	*NULL*
DETH	DETH CORPORATION	N	*NULL*
DIMHOLT	DIMHOLT CORPORATION	N	*NULL*
DIMRILL	DIMRILL CORPORATION	N	*NULL*
DIOR	DIOR CORPORATION	N	*NULL*
DOCSMITH	DOCSMITH CORPORATION	N	*NULL*
DOMINGO	DOMINGO CORPORATION	N	*NULL*
DORA	DORA CORPORATION	N	*NULL*
DORI	DORI CORPORATION	N	*NULL*
DORLYTH	DORLYTH CORPORATION	N	*NULL*
DROGO	DROGO CORPORATION	N	*NULL*
DUILIN	DUILIN CORPORATION	N	*NULL*
DUINHIR	DUINHIR CORPORATION	N	*NULL*
DUNADAN	DUNADAN CORPORATION	N	*NULL*
DUNCAN	DUNCAN CORPORATION	N	*NULL*
DUNHARROW	DUNHARROW CORPORATION	N	*NULL*
DUNHERE	DUNHERE CORPORATION	N	*NULL*
DUNLENDINGS	DUNLENDINGS CORPORATION	N	*NULL*
DUNY	DUNY CORPORATION	N	*NULL*
DURIN	DURIN CORPORATION	N	*NULL*
DURINSAXE	DURINSAXE CORPORATION	N	*NULL*
DURINSBANE	DURINSBANE CORPORATION	N	*NULL*
DWALIN	DWALIN CORPORATION	N	*NULL*
DWARVES	DWARVES CORPORATION	N	*NULL*
DWIMMERLAIK	DWIMMERLAIK CORPORATION	N	*NULL*
DWORKIN	DWORKIN CORPORATION	N	*NULL*
DYSON	DYSON CORPORATION	N	*NULL*
EAGLES	EAGLES CORPORATION	N	*NULL*
EARENDIL	EARENDIL CORPORATION	N	*NULL*
EARNUR	EARNUR CORPORATION	N	*NULL*
EASTERLINGS	EASTERLINGS CORPORATION	N	*NULL*
EASTLANDS	EASTLANDS CORPORATION	N	*NULL*
EASTROAD	EASTROAD CORPORATION	N	*NULL*
ECTHELION	ECTHELION CORPORATION	N	*NULL*
EDAIN	EDAIN CORPORATION	N	*NULL*
EESMITH	EESMITH CORPORATION	N	*NULL*
EEYORE	EEYORE CORPORATION	N	*NULL*
ELANOR	ELANOR CORPORATION	N	*NULL*
ELBERETH	ELBERETH CORPORATION	N	*NULL*
ELDAR	ELDAR CORPORATION	N	*NULL*
ELENDIL	ELENDIL CORPORATION	N	*NULL*
ELESSAR	ELESSAR CORPORATION	N	*NULL*
ELFFRIEND	ELFFRIEND CORPORATION	N	*NULL*
ELFHAVEN	ELFHAVEN CORPORATION	N	*NULL*
ELFSTONE	ELFSTONE CORPORATION	N	*NULL*
ELGIN	ELGIN CORPORATION	N	*NULL*
ELLADAN	ELLADAN CORPORATION	N	*NULL*
ELROHIR	ELROHIR CORPORATION	N	*NULL*
ELROND	ELROND CORPORATION	N	*NULL*
ELVE	ELVE CORPORATION	N	*NULL*
ELVENHOME	ELVENHOME CORPORATION	N	*NULL*
ELVENSMITHS	ELVENSMITHS CORPORATION	N	*NULL*
ELVES	ELVES CORPORATION	N	*NULL*
ELWING	ELWING CORPORATION	N	*NULL*
ENDE	ENDE CORPORATION	N	*NULL*
ENTINGS	ENTINGS CORPORATION	N	*NULL*
ENTMAIDENS	ENTMAIDENS CORPORATION	N	*NULL*
ENTS	ENTS CORPORATION	N	*NULL*
ENTWADE	ENTWADE CORPORATION	N	*NULL*
ENTWASH	ENTWASH CORPORATION	N	*NULL*
ENTWIVES	ENTWIVES CORPORATION	N	*NULL*
ENTWOOD	ENTWOOD CORPORATION	N	*NULL*
EOMER	EOMER CORPORATION	N	*NULL*
EOMUND	EOMUND CORPORATION	N	*NULL*
EORED	EORED CORPORATION	N	*NULL*
EORL	EORL CORPORATION	N	*NULL*
EORLINGAS	EORLINGAS CORPORATION	N	*NULL*
EOTHAN	EOTHAN CORPORATION	N	*NULL*
EOWYN	EOWYN CORPORATION	N	*NULL*
ERECH	ERECH CORPORATION	N	*NULL*
ERESTOR	ERESTOR CORPORATION	N	*NULL*
ERKENBRAND	ERKENBRAND CORPORATION	N	*NULL*
ESMERALDA	ESMERALDA CORPORATION	N	*NULL*
EVENDIM	EVENDIM CORPORATION	N	*NULL*
EVENSTAR	EVENSTAR CORPORATION	N	*NULL*
FAIRBAIRNS	FAIRBAIRNS CORPORATION	N	*NULL*
FAIRFOLK	FAIRFOLK CORPORATION	N	*NULL*
FALLOHIDE	FALLOHIDE CORPORATION	N	*NULL*
FANG	FANG CORPORATION	N	*NULL*
FANGORN	FANGORN CORPORATION	N	*NULL*
FANTASTICA	FANTASTICA CORPORATION	N	*NULL*
FANUIDHOL	FANUIDHOL CORPORATION	N	*NULL*
FARAMIR	FARAMIR CORPORATION	N	*NULL*
FATTYLUMPKINS	FATTYLUMPKINS CORPORATION	N	*NULL*
FEANOR	FEANOR CORPORATION	N	*NULL*
FELANOR	FELANOR CORPORATION	N	*NULL*
FELAROF	FELAROF CORPORATION	N	*NULL*
FENGEL	FENGEL CORPORATION	N	*NULL*
FERNY	FERNY CORPORATION	N	*NULL*
FEZZIK	FEZZIK CORPORATION	N	*NULL*
FIMBRETHIL	FIMBRETHIL CORPORATION	N	*NULL*
FINDUILAS	FINDUILAS CORPORATION	N	*NULL*
FINGLAS	FINGLAS CORPORATION	N	*NULL*
FINROD	FINROD CORPORATION	N	*NULL*
FIREFOOT	FIREFOOT CORPORATION	N	*NULL*
FIREMOUNTAIN	FIREMOUNTAIN CORPORATION	N	*NULL*
FIRSTBORN	FIRSTBORN CORPORATION	N	*NULL*
FLADRIF	FLADRIF CORPORATION	N	*NULL*
FLAUMEL	FLAUMEL CORPORATION	N	*NULL*
FLOI	FLOI CORPORATION	N	*NULL*
FLOURDUMPLING	FLOURDUMPLING CORPORATION	N	*NULL*
FOLCA	FOLCA CORPORATION	N	*NULL*
FORDPREFECT	FORDPREFECT CORPORATION	N	*NULL*
FORGOIL	FORGOIL CORPORATION	N	*NULL*
FORLONG	FORLONG CORPORATION	N	*NULL*
FORN	FORN CORPORATION	N	*NULL*
FORNOST	FORNOST CORPORATION	N	*NULL*
FRAR	FRAR CORPORATION	N	*NULL*
FREA	FREA CORPORATION	N	*NULL*
FREALAF	FREALAF CORPORATION	N	*NULL*
FREAWINE	FREAWINE CORPORATION	N	*NULL*
FREEFOLK	FREEFOLK CORPORATION	N	*NULL*
FREELORDS	FREELORDS CORPORATION	N	*NULL*
FREMEN	FREMEN CORPORATION	N	*NULL*
FRODO	FRODO CORPORATION	N	*NULL*
FRUMPLE	FRUMPLE CORPORATION	N	*NULL*
FUNDIN	FUNDIN CORPORATION	N	*NULL*
GAFFER	GAFFER CORPORATION	N	*NULL*
GALADON	GALADON CORPORATION	N	*NULL*
GALADRIEL	GALADRIEL CORPORATION	N	*NULL*
GALDOR	GALDOR CORPORATION	N	*NULL*
GALDRIM	GALDRIM CORPORATION	N	*NULL*
GALMOND	GALMOND CORPORATION	N	*NULL*
GAMGEE	GAMGEE CORPORATION	N	*NULL*
GAMLING	GAMLING CORPORATION	N	*NULL*
GANDALF	GANDALF CORPORATION	N	*NULL*
GARKIN	GARKIN CORPORATION	N	*NULL*
GARULF	GARULF CORPORATION	N	*NULL*
GED	GED CORPORATION	N	*NULL*
GERARD	GERARD CORPORATION	N	*NULL*
GGILDOR	GGILDOR CORPORATION	N	*NULL*
GILGALAD	GILGALAD CORPORATION	N	*NULL*
GILGAMESH	GILGAMESH CORPORATION	N	*NULL*
GILTHONIEL	GILTHONIEL CORPORATION	N	*NULL*
GIMLI	GIMLI CORPORATION	N	*NULL*
GLAMDRING	GLAMDRING CORPORATION	N	*NULL*
GLEEP	GLEEP CORPORATION	N	*NULL*
GLEOWINE	GLEOWINE CORPORATION	N	*NULL*
GLOIN	GLOIN CORPORATION	N	*NULL*
GLORFINDEL	GLORFINDEL CORPORATION	N	*NULL*
GOATLEAF	GOATLEAF CORPORATION	N	*NULL*
GOLASGIL	GOLASGIL CORPORATION	N	*NULL*
GOLDBERRY	GOLDBERRY CORPORATION	N	*NULL*
GOLDENHALL	GOLDENHALL CORPORATION	N	*NULL*
GOLDENWOOD	GOLDENWOOD CORPORATION	N	*NULL*
GOLDWINE	GOLDWINE CORPORATION	N	*NULL*
GOLLUM	GOLLUM CORPORATION	N	*NULL*
GONDOR	GONDOR CORPORATION	N	*NULL*
GOODBODIES	GOODBODIES CORPORATION	N	*NULL*
GORBADOC	GORBADOC CORPORATION	N	*NULL*
GORBAG	GORBAG CORPORATION	N	*NULL*
GORGOR	GORGOR CORPORATION	N	*NULL*
GORGUN	GORGUN CORPORATION	N	*NULL*
GORHENDAD	GORHENDAD CORPORATION	N	*NULL*
GOTHMOG	GOTHMOG CORPORATION	N	*NULL*
GRAM	GRAM CORPORATION	N	*NULL*
GRAYHAME	GRAYHAME CORPORATION	N	*NULL*
GRAYWANDERER	GRAYWANDERER CORPORATION	N	*NULL*
GREATGATE	GREATGATE CORPORATION	N	*NULL*
GREENHILL	GREENHILL CORPORATION	N	*NULL*
GREENWOOD	GREENWOOD CORPORATION	N	*NULL*
GREYHOST	GREYHOST CORPORATION	N	*NULL*
GREYMALKIN	GREYMALKIN CORPORATION	N	*NULL*
GREYPILGRIM	GREYPILGRIM CORPORATION	N	*NULL*
GREYWOOD	GREYWOOD CORPORATION	N	*NULL*
GRIMA	GRIMA CORPORATION	N	*NULL*
GRIMBEORN	GRIMBEORN CORPORATION	N	*NULL*
GRISHNAKH	GRISHNAKH CORPORATION	N	*NULL*
GRUBBS	GRUBBS CORPORATION	N	*NULL*
GUARDIANS	GUARDIANS CORPORATION	N	*NULL*
GUIDO	GUIDO CORPORATION	N	*NULL*
GURNEY	GURNEY CORPORATION	N	*NULL*
GUTHLAF	GUTHLAF CORPORATION	N	*NULL*
GUTHWINE	GUTHWINE CORPORATION	N	*NULL*
GWAIHIR	GWAIHIR CORPORATION	N	*NULL*
HADOR	HADOR CORPORATION	N	*NULL*
HALBARAD	HALBARAD CORPORATION	N	*NULL*
HALDIR	HALDIR CORPORATION	N	*NULL*
HALFAST	HALFAST CORPORATION	N	*NULL*
HALFLING	HALFLING CORPORATION	N	*NULL*
HALLOFFIRE	HALLOFFIRE CORPORATION	N	*NULL*
HAMA	HAMA CORPORATION	N	*NULL*
HAMFAST	HAMFAST CORPORATION	N	*NULL*
HARADRIM	HARADRIM CORPORATION	N	*NULL*
HARDIN	HARDIN CORPORATION	N	*NULL*
HARFOOTS	HARFOOTS CORPORATION	N	*NULL*
HARI	HARI CORPORATION	N	*NULL*
HARISELDON	HARISELDON CORPORATION	N	*NULL*
HARKONNEN	HARKONNEN CORPORATION	N	*NULL*
HARPER	HARPER CORPORATION	N	*NULL*
HASUFEL	HASUFEL CORPORATION	N	*NULL*
HAUNTED	HAUNTED CORPORATION	N	*NULL*
HAYGATE	HAYGATE CORPORATION	N	*NULL*
HAYWARD	HAYWARD CORPORATION	N	*NULL*
HEALER	HEALER CORPORATION	N	*NULL*
HEATHERTOES	HEATHERTOES CORPORATION	N	*NULL*
HEINLEIN	HEINLEIN CORPORATION	N	*NULL*
HEINOX	HEINOX CORPORATION	N	*NULL*
HELMINGAS	HELMINGAS CORPORATION	N	*NULL*
HELMSDIKE	HELMSDIKE CORPORATION	N	*NULL*
HELMSGATE	HELMSGATE CORPORATION	N	*NULL*
HENNETH	HENNETH CORPORATION	N	*NULL*
HERUGGRIM	HERUGGRIM CORPORATION	N	*NULL*
HGWELLS	HGWELLS CORPORATION	N	*NULL*
HIGHCOURT	HIGHCOURT CORPORATION	N	*NULL*
HIRGON	HIRGON CORPORATION	N	*NULL*
HIRLUIN	HIRLUIN CORPORATION	N	*NULL*
HOBBIT	HOBBIT CORPORATION	N	*NULL*
HOBBITS	HOBBITS CORPORATION	N	*NULL*
HOLBYTLA	HOLBYTLA CORPORATION	N	*NULL*
HOLDWINE	HOLDWINE CORPORATION	N	*NULL*
HOLMAN	HOLMAN CORPORATION	N	*NULL*
HORA	HORA CORPORATION	N	*NULL*
HORNBLOWER	HORNBLOWER CORPORATION	N	*NULL*
HORSELORDS	HORSELORDS CORPORATION	N	*NULL*
HUMFEY	HUMFEY CORPORATION	N	*NULL*
HUORNS	HUORNS CORPORATION	N	*NULL*
HURIN	HURIN CORPORATION	N	*NULL*
IARWAIN	IARWAIN CORPORATION	N	*NULL*
IMLADMORGUL	IMLADMORGUL CORPORATION	N	*NULL*
IMLADRIS	IMLADRIS CORPORATION	N	*NULL*
IMRAHIL	IMRAHIL CORPORATION	N	*NULL*
INCANUS	INCANUS CORPORATION	N	*NULL*
INGLORION	INGLORION CORPORATION	N	*NULL*
INGOLD	INGOLD CORPORATION	N	*NULL*
INIGO	INIGO CORPORATION	N	*NULL*
IORETH	IORETH CORPORATION	N	*NULL*
IORLAS	IORLAS CORPORATION	N	*NULL*
ISEN	ISEN CORPORATION	N	*NULL*
ISENGARD	ISENGARD CORPORATION	N	*NULL*
ISENGARDERS	ISENGARDERS CORPORATION	N	*NULL*
ISENGRIM	ISENGRIM CORPORATION	N	*NULL*
ISENMOUTHE	ISENMOUTHE CORPORATION	N	*NULL*
ISILDUR	ISILDUR CORPORATION	N	*NULL*
ITHIL	ITHIL CORPORATION	N	*NULL*
ITHILSTONE	ITHILSTONE CORPORATION	N	*NULL*
JAXOM	JAXOM CORPORATION	N	*NULL*
JINX	JINX CORPORATION	N	*NULL*
JINXIAN	JINXIAN CORPORATION	N	*NULL*
JULIAN	JULIAN CORPORATION	N	*NULL*
KANGA	KANGA CORPORATION	N	*NULL*
KHAZADDUM	KHAZADDUM CORPORATION	N	*NULL*
KIRK	KIRK CORPORATION	N	*NULL*
KOLVIR	KOLVIR CORPORATION	N	*NULL*
KOSSIL	KOSSIL CORPORATION	N	*NULL*
LAGDUF	LAGDUF CORPORATION	N	*NULL*
LAMEDON	LAMEDON CORPORATION	N	*NULL*
LAMPWRIGHTS	LAMPWRIGHTS CORPORATION	N	*NULL*
LANDROVAL	LANDROVAL CORPORATION	N	*NULL*
LARRYNIVEN	LARRYNIVEN CORPORATION	N	*NULL*
LATHEOFHEAVEN	LATHEOFHEAVEN CORPORATION	N	*NULL*
LATHSPELL	LATHSPELL CORPORATION	N	*NULL*
LAURELINDORNAN	LAURELINDORNAN CORPORATION	N	*NULL*
LAZARUS	LAZARUS CORPORATION	N	*NULL*
LEAFLOCK	LEAFLOCK CORPORATION	N	*NULL*
LEETAH	LEETAH CORPORATION	N	*NULL*
LEGOLAS	LEGOLAS CORPORATION	N	*NULL*
LEMBAS	LEMBAS CORPORATION	N	*NULL*
LENSMAN	LENSMAN CORPORATION	N	*NULL*
LEOF	LEOF CORPORATION	N	*NULL*
LETO	LETO CORPORATION	N	*NULL*
LIMLIGHT	LIMLIGHT CORPORATION	N	*NULL*
LINDIR	LINDIR CORPORATION	N	*NULL*
LOBELIA	LOBELIA CORPORATION	N	*NULL*
LOCKHOLES	LOCKHOLES CORPORATION	N	*NULL*
LONGBOTTOM	LONGBOTTOM CORPORATION	N	*NULL*
LONGHOLES	LONGHOLES CORPORATION	N	*NULL*
LONGLAKE	LONGLAKE CORPORATION	N	*NULL*
LOOKATTHAT	LOOKATTHAT CORPORATION	N	*NULL*
LOOKITTHAT	LOOKITTHAT CORPORATION	N	*NULL*
LORDOFEVIL	LORDOFEVIL CORPORATION	N	*NULL*
LOTHO	LOTHO CORPORATION	N	*NULL*
LOUDWATER	LOUDWATER CORPORATION	N	*NULL*
LOUISWU	LOUISWU CORPORATION	N	*NULL*
LUGDUSH	LUGDUSH CORPORATION	N	*NULL*
LUMPKIN	LUMPKIN CORPORATION	N	*NULL*
LUMPKINS	LUMPKINS CORPORATION	N	*NULL*
LUNE	LUNE CORPORATION	N	*NULL*
LUTHIEN	LUTHIEN CORPORATION	N	*NULL*
MABLUNG	MABLUNG CORPORATION	N	*NULL*
MAGGOT	MAGGOT CORPORATION	N	*NULL*
MALBETH	MALBETH CORPORATION	N	*NULL*
MARDIL	MARDIL CORPORATION	N	*NULL*
MARIGOLD	MARIGOLD CORPORATION	N	*NULL*
MARVIN	MARVIN CORPORATION	N	*NULL*
MAUHUR	MAUHUR CORPORATION	N	*NULL*
MEARAS	MEARAS CORPORATION	N	*NULL*
MEDUSELD	MEDUSELD CORPORATION	N	*NULL*
MELANGE	MELANGE CORPORATION	N	*NULL*
MELILOT	MELILOT CORPORATION	N	*NULL*
MENELDIL	MENELDIL CORPORATION	N	*NULL*
MENELDOR	MENELDOR CORPORATION	N	*NULL*
MELNIBONE	MELNIBONE CORPORATION	N	*NULL*
MENOLLY	MENOLLY CORPORATION	N	*NULL*
MENTAT	MENTAT CORPORATION	N	*NULL*
MERIADOC	MERIADOC CORPORATION	N	*NULL*
METHEDRAS	METHEDRAS CORPORATION	N	*NULL*
MICHELDELVING	MICHELDELVING CORPORATION	N	*NULL*
MIDDLEARTH	MIDDLEARTH CORPORATION	N	*NULL*
MIDDLEEARTH	MIDDLEEARTH CORPORATION	N	*NULL*
MILO	MILO CORPORATION	N	*NULL*
MINASANOR	MINASANOR CORPORATION	N	*NULL*
MINASITHIL	MINASITHIL CORPORATION	N	*NULL*
MINASTIRITH	MINASTIRITH CORPORATION	N	*NULL*
MINUSMORGUL	MINUSMORGUL CORPORATION	N	*NULL*
MIRKWOOD	MIRKWOOD CORPORATION	N	*NULL*
MIRROWMERE	MIRROWMERE CORPORATION	N	*NULL*
MISTERSPOCK	MISTERSPOCK CORPORATION	N	*NULL*
MISTYMOUNTAIN	MISTYMOUNTAIN CORPORATION	N	*NULL*
MITHEITHEL	MITHEITHEL CORPORATION	N	*NULL*
MITHRANDIR	MITHRANDIR CORPORATION	N	*NULL*
MITHRIL	MITHRIL CORPORATION	N	*NULL*
MOGUL	MOGUL CORPORATION	N	*NULL*
MOMO	MOMO CORPORATION	N	*NULL*
MOONRIDER	MOONRIDER CORPORATION	N	*NULL*
MORANNON	MORANNON CORPORATION	N	*NULL*
MORDOR	MORDOR CORPORATION	N	*NULL*
MORGON	MORGON CORPORATION	N	*NULL*
MORGUL	MORGUL CORPORATION	N	*NULL*
MORGULLORD	MORGULLORD CORPORATION	N	*NULL*
MORGULPASS	MORGULPASS CORPORATION	N	*NULL*
MORGULVALE	MORGULVALE CORPORATION	N	*NULL*
MORIA	MORIA CORPORATION	N	*NULL*
MOTIE	MOTIE CORPORATION	N	*NULL*
MOUNTDOOM	MOUNTDOOM CORPORATION	N	*NULL*
MOUNTFANG	MOUNTFANG CORPORATION	N	*NULL*
MRSPOCK	MRSPOCK CORPORATION	N	*NULL*
MTLOOKATTHAT	MTLOOKATTHAT CORPORATION	N	*NULL*
MTLOOKITTHAT	MTLOOKITTHAT CORPORATION	N	*NULL*
MUAD DIB	MUAD DIB CORPORATION	N	*NULL*
MUAD-DIB	MUAD-DIB CORPORATION	N	*NULL*
MUADDIB	MUADDIB CORPORATION	N	*NULL*
MUGWORT	MUGWORT CORPORATION	N	*NULL*
MULE	MULE CORPORATION	N	*NULL*
MUMAK	MUMAK CORPORATION	N	*NULL*
MUMAKIL	MUMAKIL CORPORATION	N	*NULL*
MUZGASH	MUZGASH CORPORATION	N	*NULL*
NALI	NALI CORPORATION	N	*NULL*
NAMELESS	NAMELESS CORPORATION	N	*NULL*
NARSIL	NARSIL CORPORATION	N	*NULL*
NARVI	NARVI CORPORATION	N	*NULL*
NAZGUL	NAZGUL CORPORATION	N	*NULL*
NECROMANCER	NECROMANCER CORPORATION	N	*NULL*
NEEKERBREAKERS	NEEKERBREAKERS CORPORATION	N	*NULL*
NESSUS	NESSUS CORPORATION	N	*NULL*
NEUROMANCER	NEUROMANCER CORPORATION	N	*NULL*
NEWROW	NEWROW CORPORATION	N	*NULL*
NIBS	NIBS CORPORATION	N	*NULL*
NIMRODEL	NIMRODEL CORPORATION	N	*NULL*
NIVEN	NIVEN CORPORATION	N	*NULL*
NOAKES	NOAKES CORPORATION	N	*NULL*
NOB	NOB CORPORATION	N	*NULL*
NOLDOR	NOLDOR CORPORATION	N	*NULL*
NORI	NORI CORPORATION	N	*NULL*
NORTHFARTHING	NORTHFARTHING CORPORATION	N	*NULL*
NOVA	NOVA CORPORATION	N	*NULL*
NUMEMOREANS	NUMEMOREANS CORPORATION	N	*NULL*
NUMENOR	NUMENOR CORPORATION	N	*NULL*
OAKENSHIELD	OAKENSHIELD CORPORATION	N	*NULL*
OHTAR	OHTAR CORPORATION	N	*NULL*
OIN	OIN CORPORATION	N	*NULL*
OISEN	OISEN CORPORATION	N	*NULL*
OLDBUCK	OLDBUCK CORPORATION	N	*NULL*
OLDFOREST	OLDFOREST CORPORATION	N	*NULL*
OLDNOAKES	OLDNOAKES CORPORATION	N	*NULL*
OLDODO	OLDODO CORPORATION	N	*NULL*
OLIPHAUNT	OLIPHAUNT CORPORATION	N	*NULL*
OLORIN	OLORIN CORPORATION	N	*NULL*
ONODRIM	ONODRIM CORPORATION	N	*NULL*
ORALD	ORALD CORPORATION	N	*NULL*
ORCRIST	ORCRIST CORPORATION	N	*NULL*
ORCS	ORCS CORPORATION	N	*NULL*
ORODRUIN	ORODRUIN CORPORATION	N	*NULL*
OROME	OROME CORPORATION	N	*NULL*
OROPHIN	OROPHIN CORPORATION	N	*NULL*
ORTHANC	ORTHANC CORPORATION	N	*NULL*
OSGILIATH	OSGILIATH CORPORATION	N	*NULL*
OTHO	OTHO CORPORATION	N	*NULL*
OUTLANDS	OUTLANDS CORPORATION	N	*NULL*
OVERHEAVEN	OVERHEAVEN CORPORATION	N	*NULL*
PAK	PAK CORPORATION	N	*NULL*
PAKPROTECTOR	PAKPROTECTOR CORPORATION	N	*NULL*
PALADIN	PALADIN CORPORATION	N	*NULL*
PALANTIR	PALANTIR CORPORATION	N	*NULL*
PELENNOR	PELENNOR CORPORATION	N	*NULL*
PELMAN	PELMAN CORPORATION	N	*NULL*
PENTHE	PENTHE CORPORATION	N	*NULL*
PEREGRINE	PEREGRINE CORPORATION	N	*NULL*
PERIAN	PERIAN CORPORATION	N	*NULL*
PERN	PERN CORPORATION	N	*NULL*
PEZI	PEZI CORPORATION	N	*NULL*
PHERIANNATH	PHERIANNATH CORPORATION	N	*NULL*
PICKTHORN	PICKTHORN CORPORATION	N	*NULL*
PIEMUR	PIEMUR CORPORATION	N	*NULL*
PIGLET	PIGLET CORPORATION	N	*NULL*
PIMPLE	PIMPLE CORPORATION	N	*NULL*
PIPEWEED	PIPEWEED CORPORATION	N	*NULL*
POHL	POHL CORPORATION	N	*NULL*
POOH	POOH CORPORATION	N	*NULL*
POOHBEAR	POOHBEAR CORPORATION	N	*NULL*
PRILL	PRILL CORPORATION	N	*NULL*
PRIMULA	PRIMULA CORPORATION	N	*NULL*
PROTECTOR	PROTECTOR CORPORATION	N	*NULL*
PROUDFOOT	PROUDFOOT CORPORATION	N	*NULL*
PUDDIFOOT	PUDDIFOOT CORPORATION	N	*NULL*
QUICKBEAM	QUICKBEAM CORPORATION	N	*NULL*
RADAGAST	RADAGAST CORPORATION	N	*NULL*
RADBUG	RADBUG CORPORATION	N	*NULL*
RAEDERLE	RAEDERLE CORPORATION	N	*NULL*
RANDOM	RANDOM CORPORATION	N	*NULL*
RANGERS	RANGERS CORPORATION	N	*NULL*
REDBOOK	REDBOOK CORPORATION	N	*NULL*
REIN	REIN CORPORATION	N	*NULL*
RENEWER	RENEWER CORPORATION	N	*NULL*
RIDDERMARK	RIDDERMARK CORPORATION	N	*NULL*
RINGWAITHS	RINGWAITHS CORPORATION	N	*NULL*
RINGWORLD	RINGWORLD CORPORATION	N	*NULL*
RIVENDELL	RIVENDELL CORPORATION	N	*NULL*
ROBINTON	ROBINTON CORPORATION	N	*NULL*
ROHAN	ROHAN CORPORATION	N	*NULL*
ROHANGAP	ROHANGAP CORPORATION	N	*NULL*
ROHANWOLD	ROHANWOLD CORPORATION	N	*NULL*
ROHERYN	ROHERYN CORPORATION	N	*NULL*
ROHIRRIM	ROHIRRIM CORPORATION	N	*NULL*
RORY	RORY CORPORATION	N	*NULL*
ROSHA	ROSHA CORPORATION	N	*NULL*
RUATHA	RUATHA CORPORATION	N	*NULL*
RUMIL	RUMIL CORPORATION	N	*NULL*
RUNES	RUNES CORPORATION	N	*NULL*
RUSHLIGHT	RUSHLIGHT CORPORATION	N	*NULL*
SACKVILLE	SACKVILLE CORPORATION	N	*NULL*
SAMWISE	SAMWISE CORPORATION	N	*NULL*
SANCHO	SANCHO CORPORATION	N	*NULL*
SANDHEAVER	SANDHEAVER CORPORATION	N	*NULL*
SANDMAN	SANDMAN CORPORATION	N	*NULL*
SANDYMAN	SANDYMAN CORPORATION	N	*NULL*
SARADOC	SARADOC CORPORATION	N	*NULL*
SARUMAN	SARUMAN CORPORATION	N	*NULL*
SAURON	SAURON CORPORATION	N	*NULL*
SCATHA	SCATHA CORPORATION	N	*NULL*
SELDON	SELDON CORPORATION	N	*NULL*
SELIDOR	SELIDOR CORPORATION	N	*NULL*
SHADOWFAX	SHADOWFAX CORPORATION	N	*NULL*
SHADOWHOST	SHADOWHOST CORPORATION	N	*NULL*
SHADOWS	SHADOWS CORPORATION	N	*NULL*
SHAGRAT	SHAGRAT CORPORATION	N	*NULL*
SHARKEY	SHARKEY CORPORATION	N	*NULL*
SHARKU	SHARKU CORPORATION	N	*NULL*
SHELOB	SHELOB CORPORATION	N	*NULL*
SHIRE	SHIRE CORPORATION	N	*NULL*
SHIRRIFFS	SHIRRIFFS CORPORATION	N	*NULL*
SHRIEKERS	SHRIEKERS CORPORATION	N	*NULL*
SILVERLODE	SILVERLODE CORPORATION	N	*NULL*
SIMBELMYNE	SIMBELMYNE CORPORATION	N	*NULL*
SKEEVE	SKEEVE CORPORATION	N	*NULL*
SKINBARK	SKINBARK CORPORATION	N	*NULL*
SKYWISE	SKYWISE CORPORATION	N	*NULL*
SLARTY	SLARTY CORPORATION	N	*NULL*
SLARTYBARTFAST	SLARTYBARTFAST CORPORATION	N	*NULL*
SLINKER	SLINKER CORPORATION	N	*NULL*
SMALLBURROW	SMALLBURROW CORPORATION	N	*NULL*
SMAUG	SMAUG CORPORATION	N	*NULL*
SMEAGOL	SMEAGOL CORPORATION	N	*NULL*
SNAGA	SNAGA CORPORATION	N	*NULL*
SNOWBOURN	SNOWBOURN CORPORATION	N	*NULL*
SNOWMANE	SNOWMANE CORPORATION	N	*NULL*
SORCERY	SORCERY CORPORATION	N	*NULL*
SOUTHFARTHING	SOUTHFARTHING CORPORATION	N	*NULL*
SOUTHRONS	SOUTHRONS CORPORATION	N	*NULL*
SPOCK	SPOCK CORPORATION	N	*NULL*
STARTREK	STARTREK CORPORATION	N	*NULL*
STEWARDS	STEWARDS CORPORATION	N	*NULL*
STILGAR	STILGAR CORPORATION	N	*NULL*
STING	STING CORPORATION	N	*NULL*
STINKER	STINKER CORPORATION	N	*NULL*
STONECITY	STONECITY CORPORATION	N	*NULL*
STONEFOLK	STONEFOLK CORPORATION	N	*NULL*
STOORS	STOORS CORPORATION	N	*NULL*
STORMCROW	STORMCROW CORPORATION	N	*NULL*
STRAWHEADS	STRAWHEADS CORPORATION	N	*NULL*
STRIDER	STRIDER CORPORATION	N	*NULL*
STRONGBOW	STRONGBOW CORPORATION	N	*NULL*
STYBBA	STYBBA CORPORATION	N	*NULL*
SUNLANDS	SUNLANDS CORPORATION	N	*NULL*
SUPERNOVA	SUPERNOVA CORPORATION	N	*NULL*
SUTH	SUTH CORPORATION	N	*NULL*
SWERTINGS	SWERTINGS CORPORATION	N	*NULL*
TANDA	TANDA CORPORATION	N	*NULL*
TARGON	TARGON CORPORATION	N	*NULL*
TARKS	TARKS CORPORATION	N	*NULL*
TEETHOFMORDOR	TEETHOFMORDOR CORPORATION	N	*NULL*
TELCHAR	TELCHAR CORPORATION	N	*NULL*
TELCONTAR	TELCONTAR CORPORATION	N	*NULL*
TERMINUS	TERMINUS CORPORATION	N	*NULL*
THAINTOOK	THAINTOOK CORPORATION	N	*NULL*
THARKUN	THARKUN CORPORATION	N	*NULL*
THECHIEF	THECHIEF CORPORATION	N	*NULL*
THECITY	THECITY CORPORATION	N	*NULL*
THEDEAD	THEDEAD CORPORATION	N	*NULL*
THEEDAIN	THEEDAIN CORPORATION	N	*NULL*
THEMULE	THEMULE CORPORATION	N	*NULL*
THENGEL	THENGEL CORPORATION	N	*NULL*
THENINE	THENINE CORPORATION	N	*NULL*
THEODEN	THEODEN CORPORATION	N	*NULL*
THEODRED	THEODRED CORPORATION	N	*NULL*
THESEER	THESEER CORPORATION	N	*NULL*
THESHIRE	THESHIRE CORPORATION	N	*NULL*
THETOMBS	THETOMBS CORPORATION	N	*NULL*
THEVALAR	THEVALAR CORPORATION	N	*NULL*
THEWISE	THEWISE CORPORATION	N	*NULL*
THINGOL	THINGOL CORPORATION	N	*NULL*
THISTLEWOOL	THISTLEWOOL CORPORATION	N	*NULL*
THORNI	THORNI CORPORATION	N	*NULL*
THORONDOR	THORONDOR CORPORATION	N	*NULL*
THRAIN	THRAIN CORPORATION	N	*NULL*
THRANDRUIL	THRANDRUIL CORPORATION	N	*NULL*
THREEFARTHING	THREEFARTHING CORPORATION	N	*NULL*
THROR	THROR CORPORATION	N	*NULL*
THUGANLITHA	THUGANLITHA CORPORATION	N	*NULL*
TIGGER	TIGGER CORPORATION	N	*NULL*
TIMESAVING	TIMESAVING CORPORATION	N	*NULL*
TINDROCK	TINDROCK CORPORATION	N	*NULL*
TIRITH	TIRITH CORPORATION	N	*NULL*
TNUCTIPUN	TNUCTIPUN CORPORATION	N	*NULL*
TOBOLD	TOBOLD CORPORATION	N	*NULL*
TOOK	TOOK CORPORATION	N	*NULL*
TOOKLAND	TOOKLAND CORPORATION	N	*NULL*
TORAN	TORAN CORPORATION	N	*NULL*
TORECH	TORECH CORPORATION	N	*NULL*
TOWERHILLS	TOWERHILLS CORPORATION	N	*NULL*
TRANTOR	TRANTOR CORPORATION	N	*NULL*
TREEBEARD	TREEBEARD CORPORATION	N	*NULL*
TRENT	TRENT CORPORATION	N	*NULL*
TRILLIAN	TRILLIAN CORPORATION	N	*NULL*
TRISTAN	TRISTAN CORPORATION	N	*NULL*
TROLL	TROLL CORPORATION	N	*NULL*
TROLLS	TROLLS CORPORATION	N	*NULL*
TRUENAMES	TRUENAMES CORPORATION	N	*NULL*
TURIN	TURIN CORPORATION	N	*NULL*
TWEENER	TWEENER CORPORATION	N	*NULL*
TWEENEY	TWEENEY CORPORATION	N	*NULL*
TWEENY	TWEENY CORPORATION	N	*NULL*
TWOFOOT	TWOFOOT CORPORATION	N	*NULL*
UFTHAK	UFTHAK CORPORATION	N	*NULL*
UGLUK	UGLUK CORPORATION	N	*NULL*
UMBAR	UMBAR CORPORATION	N	*NULL*
UNDERHILL	UNDERHILL CORPORATION	N	*NULL*
UNGOL	UNGOL CORPORATION	N	*NULL*
UNGOLIANT	UNGOLIANT CORPORATION	N	*NULL*
URUKHAI	URUKHAI CORPORATION	N	*NULL*
URUKS	URUKS CORPORATION	N	*NULL*
VALANDIL	VALANDIL CORPORATION	N	*NULL*
VALAR	VALAR CORPORATION	N	*NULL*
VARDA	VARDA CORPORATION	N	*NULL*
VARIAGS	VARIAGS CORPORATION	N	*NULL*
VERNE	VERNE CORPORATION	N	*NULL*
VERNOR	VERNOR CORPORATION	N	*NULL*
VERNORVINGE	VERNORVINGE CORPORATION	N	*NULL*
VICIA	VICIA CORPORATION	N	*NULL*
VINGE	VINGE CORPORATION	N	*NULL*
VOGON	VOGON CORPORATION	N	*NULL*
VORONDIL	VORONDIL CORPORATION	N	*NULL*
WALDA	WALDA CORPORATION	N	*NULL*
WANDERER	WANDERER CORPORATION	N	*NULL*
WANDLIMB	WANDLIMB CORPORATION	N	*NULL*
WARDEN	WARDEN CORPORATION	N	*NULL*
WARGS	WARGS CORPORATION	N	*NULL*
WATCHER	WATCHER CORPORATION	N	*NULL*
WATCHWOOD	WATCHWOOD CORPORATION	N	*NULL*
WAYBREAD	WAYBREAD CORPORATION	N	*NULL*
WELLS	WELLS CORPORATION	N	*NULL*
WEMADEIT	WEMADEIT CORPORATION	N	*NULL*
WESTFOLD	WESTFOLD CORPORATION	N	*NULL*
WESTLEY	WESTLEY CORPORATION	N	*NULL*
WESTMARCHES	WESTMARCHES CORPORATION	N	*NULL*
WESTROAD	WESTROAD CORPORATION	N	*NULL*
WEYR	WEYR CORPORATION	N	*NULL*
WHITEDOWNS	WHITEDOWNS CORPORATION	N	*NULL*
WHITEHAND	WHITEHAND CORPORATION	N	*NULL*
WHITEMOUNTAINS	WHITEMOUNTAINS CORPORATION	N	*NULL*
WHITERIDER	WHITERIDER CORPORATION	N	*NULL*
WHITESKINS	WHITESKINS CORPORATION	N	*NULL*
WHITETOWER	WHITETOWER CORPORATION	N	*NULL*
WHITFOOT	WHITFOOT CORPORATION	N	*NULL*
WIDFARA	WIDFARA CORPORATION	N	*NULL*
WIGHTS	WIGHTS CORPORATION	N	*NULL*
WILDERLAND	WILDERLAND CORPORATION	N	*NULL*
WILDMAN	WILDMAN CORPORATION	N	*NULL*
WILDMEN	WILDMEN CORPORATION	N	*NULL*
WILDWOOD	WILDWOOD CORPORATION	N	*NULL*
WINDFOLA	WINDFOLA CORPORATION	N	*NULL*
WINGED	WINGED CORPORATION	N	*NULL*
WINGFOOT	WINGFOOT CORPORATION	N	*NULL*
WINNIE	WINNIE CORPORATION	N	*NULL*
WINNOWILL	WINNOWILL CORPORATION	N	*NULL*
WITCH	WITCH CORPORATION	N	*NULL*
WITCHLORD	WITCHLORD CORPORATION	N	*NULL*
WIZARD	WIZARD CORPORATION	N	*NULL*
WIZARDS	WIZARDS CORPORATION	N	*NULL*
WIZARDSVALE	WIZARDSVALE CORPORATION	N	*NULL*
WOLF	WOLF CORPORATION	N	*NULL*
WOLFRIDER	WOLFRIDER CORPORATION	N	*NULL*
WOLFRIDERS	WOLFRIDERS CORPORATION	N	*NULL*
WOODLAND	WOODLAND CORPORATION	N	*NULL*
WOODMEN	WOODMEN CORPORATION	N	*NULL*
WORMTONGUE	WORMTONGUE CORPORATION	N	*NULL*
WOSES	WOSES CORPORATION	N	*NULL*
WRAITH	WRAITH CORPORATION	N	*NULL*
WRAITHS	WRAITHS CORPORATION	N	*NULL*
XANTH	XANTH CORPORATION	N	*NULL*
YRCH	YRCH CORPORATION	N	*NULL*
YRTH	YRTH CORPORATION	N	*NULL*
ZAPHOD	ZAPHOD CORPORATION	N	*NULL*
ZARDOZ	ZARDOZ CORPORATION	N	*NULL*
ZARNIWOOP	ZARNIWOOP CORPORATION	N	*NULL*
ZIRAK	ZIRAK CORPORATION	N	*NULL*
ZIRAKZIGIL	ZIRAKZIGIL CORPORATION	N	*NULL*
